1111111101111
1000000P00001
1000000000001
1000000000001
100H0000C0001
10000000000E1
1111111111111
