11111111111111111111
1000000000010000E001
100000P0000100000001
100000000000000C0001
100000C0000000000001
10000000000000000001
10000000000000000001
10000H00000C00000001
100C0000000000000001
11111111111111111111
