11111111111111111111
1000000P000100000001
100C0000000100C00001
1000000H000000000001
10H00000000000H00001
1000000C000000000001
10000000000000000001
10000H00000000C000H1
10000000000000000E01
11111111111111111111
