111111111111111
1000P00000C00E1
111111111111111
