111111111111111
1H00P00000C00E1
111111111111111
