111111111111111111111
100P000000010C0HC0001
111110000001000000001
1000C0000001000000001
1000H0000001000000001
1000C0000000000000001
1000000000000000E0001
111111111111111111111
